TEAM_ID,TEAM_NAME,TEAM_ABBREVIATION,GP,G,FGA_FREQUENCY,FGM,FGA,FG_PCT,EFG_PCT,FG2A_FREQUENCY,FG2M,FG2A,FG2_PCT,FG3A_FREQUENCY,FG3M,FG3A,FG3_PCT
1610612748,Miami Heat,MIA,21,21,1.0,800,1760,0.455,0.528,0.577,540,1015,0.532,0.423,260,745,0.349
1610612747,Los Angeles Lakers,LAL,21,21,1.0,768,1695,0.453,0.525,0.601,524,1019,0.514,0.399,244,676,0.361
1610612743,Denver Nuggets,DEN,19,19,1.0,744,1561,0.477,0.551,0.602,512,939,0.545,0.398,232,622,0.373
1610612738,Boston Celtics,BOS,17,17,1.0,619,1463,0.423,0.489,0.574,425,840,0.506,0.426,194,623,0.311
1610612746,LA Clippers,LAC,13,13,1.0,517,1103,0.469,0.542,0.591,355,652,0.544,0.409,162,451,0.359
1610612745,Houston Rockets,HOU,12,12,1.0,464,1004,0.462,0.534,0.584,319,586,0.544,0.416,145,418,0.347
1610612761,Toronto Raptors,TOR,11,11,1.0,405,945,0.429,0.507,0.531,256,502,0.51,0.469,149,443,0.336
1610612749,Milwaukee Bucks,MIL,10,10,1.0,372,849,0.438,0.527,0.529,222,449,0.494,0.471,150,400,0.375
1610612760,Oklahoma City Thunder,OKC,7,7,1.0,276,634,0.435,0.536,0.438,148,278,0.532,0.562,128,356,0.36
1610612762,Utah Jazz,UTA,7,7,1.0,281,602,0.467,0.555,0.581,175,350,0.5,0.419,106,252,0.421
1610612742,Dallas Mavericks,DAL,6,6,1.0,271,541,0.501,0.579,0.616,187,333,0.562,0.384,84,208,0.404
1610612757,Portland Trail Blazers,POR,5,5,1.0,214,442,0.484,0.552,0.604,154,267,0.577,0.396,60,175,0.343
1610612753,Orlando Magic,ORL,5,5,1.0,210,437,0.481,0.569,0.535,133,234,0.568,0.465,77,203,0.379
1610612751,Brooklyn Nets,BKN,4,4,1.0,180,364,0.495,0.592,0.549,109,200,0.545,0.451,71,164,0.433
1610612755,Philadelphia 76ers,PHI,4,4,1.0,156,345,0.452,0.523,0.594,107,205,0.522,0.406,49,140,0.35
1610612754,Indiana Pacers,IND,4,4,1.0,150,323,0.464,0.545,0.588,98,190,0.516,0.412,52,133,0.391
